XXXXXXXXXXXXXXXXXXXXXXXXX
X           X   X       X
XXX X XXXXX XXX XXXXX XXX
X X X   X   X     X X X X
X X XXXXXXXXX X XXX X X X
X     X X   X X   X   X X
X X XXX X XXXXX X X X X X
X X     X X X   X X X   X
X XXXXX X X X XXXXX X XXX
X X             X   X X X
X XXXXXXXXX X X XXX XXX X
X   X X    SX X   X   X X
XXX X XXXXX XXXXXXX XXX X
X   X       X   X     X X
XXX XXXXX XXXXX X X XXX X
X X X   X X X   X X  E  X
X X X XXX X XXX XXXXX X X
X   X X X             X X
X X X X X XXXXXXX X XXX X
X X X X   X X   X X X X X
X X X XXX X X XXXXXXX X X
X X   X X X             X
XXX XXX X XXXXX X X X XXX
X   X     X     X X X   X
XXXXXXXXXXXXXXXXXXXXXXXXX