XXXXXXXXXXXXXXXXXXXXXXXXX
X   X X X       X       X
X XXX X X XXX XXX X XXX X
X X X X X X       X   X X
X X X X X XXXXXXXXXXXXX X
X               X   X X X
X XXXXXXX XXX X XXX X XXX
X   X   X X X X       X X
XXX X XXX X XXX X XXX X X
X     X  E  X X X X     X
X XXX XXX X X XXX XXXXXXX
X X X X X X     X       X
X X XXX XXXXX XXXXX XXX X
X X X       X X   X X X X
X X XXXXXXX X X X XXX X X
X   X     X X X X     X X
XXXXXXXXX X X X XXXXXXXXX
X   X   XS      X     X X
X X XXX XXX XXX XXXXX X X
X X X X X     X         X
XXX X X X XXXXXXX XXX XXX
X   X   X X       X X   X
X X X X X XXX X X X X XXX
X X   X   X   X X   X   X
XXXXXXXXXXXXXXXXXXXXXXXXX