XXXXXXXXXX
X        X
XXX XXXXSX
X    X   X
X XXXX X X
X X    X X
X XXXXXX X
X   XXXX X
XXX EX   X
XXXXXXXXXX