XXXXXXXXXXXXXXXXXXXXXXXXX
X     X     X   X X     X
XXXXX XXX XXXXX X X X X X
X     X   X         X X X
X XXX XXX XXX XXX X XXX X
X X X   X X X X   X X   X
XXX XXX X X XXXXX XXXXX X
X X X X     X     X    SX
X X X XXX X X XXXXX X X X
X   X X   X     X   X X X
XXX X XXXXX XXX XXXXXXX X
X     X       X X       X
X X X XXX XXXXX X XXX XXX
X X X     X X X X X     X
XXXXXXX X X X XXXXX XXXXX
X     X X X     X   X   X
X XXX XXX X XXX XXX XXX X
X X   X       X   X  E  X
XXX XXX X XXXXX XXX XXXXX
X X     X   X X X X     X
X X XXX X XXX XXX XXXXX X
X     X X   X     X     X
XXX X XXXXXXXXX X XXX XXX
X   X X         X       X
XXXXXXXXXXXXXXXXXXXXXXXXX