XXXXXXXXXXXXXXXXXXXXXXXXX
X   X X X               X
X XXX X XXX XXXXX XXX X X
X     X X X X   X X X X X
XXX XXX X XXXXX XXX X XXX
X       X X X X         X
XXXXXXX X X X X XXX X XXX
X   X     X       X X X X
XXX XXX XXX XXX XXXXX X X
X     X     X     X X X X
X X XXX XXX XXXXXXX XXX X
X X       X X   X X X X X
X XXX XXX X X XXX X X X X
X X X X   X             X
X X XXXXX XXXXX XXX XXXXX
X     X     X X X   X   X
XXXXX XXX XXX X X XXXXX X
XS      X   X X X   X X X
XXXXXXX X XXX XXX XXX X X
X       X X             X
X X XXXXXXXXXXX XXX XXX X
X X X X   X X X X X X   X
X X X X XXX X X X X XXX X
X X         XE    X   X X
XXXXXXXXXXXXXXXXXXXXXXXXX