XXXXXXXXXXXXXXXXXXXXXXXXX
X X X X X X X     X X X X
X X X X X X X XXX X X X X
X       X X X   X     X X
X X XXXXX X XXXXX XXXXX X
X X     X X   X     X   X
X XXX X X X XXXXX XXXXX X
X   X X     X X         X
X X X XXXXXXX XXXXX X X X
X X X         X     X X X
XXX X XXXXXXXXXXXXX XXXXX
X X X     X         X   X
X XXX X X XXXXX X X X XXX
X     X X       X X   X X
XXXXX X XXXXXXX X X XXX X
X X   X X X X   X X     X
X XXX XXX X XXX XXX XXXXX
X X     X   X   X X     X
X XXX XXX XXXXXXX XXX XXX
X   X   X X X   X       X
XXX X X X X XXX XXX X XXX
X  EX X   X         X  SX
X X X X XXX XXXXXXX X X X
X X   X X     X     X X X
XXXXXXXXXXXXXXXXXXXXXXXXX
