XXXXXXXXXXXXXXXXXXXXXXXXXXXXXXXXXXXXXXXXXXXXXXX
X     X   X X     X       X       X   X       X
X X X XXX X X XXXXX X XXXXX X X X X XXXXXXX X X
X X X X   X X X X   X   X   X X X X X X     X X
XXXXX X X X X X XXX X X XXXXXXX XXX X XXXXX XXX
X     X X         X X X   X   X       X   X X X
X X XXXXXXX X X X X X X X X XXX X X XXXXX X X X
X X     X   X X X X X X X X     X X   X   X   X
XXXXX XXXXXXXXXXX XXX XXXXXXX XXXXXXX XXX X XXX
X       X   X       X       X     X       X X X
XXX XXXXX X X XXXXX XXX XXX XXXXXXX XXX XXX X X
X X   X   XSX X   X     X     X   X   X   X X X
X XXX XXX XXX X XXX XXX XXX XXXXX X XXXXXXX X X
X X   X         X   X   X   X       X   X     X
X X X X XXXXXXXXXXX X X XXXXX XXX X X X XXXXX X
X   X           X   X X   X     X X   X       X
XXXXXXX XXX XXXXXXXXXXX XXX XXX X XXX X X XXXXX
X   X   X   X       X         X X X   X X   X X
XXX XXX XXXXXXX X XXX X X XXXXXXXXXXXXXXX XXX X
X       X       X   X X X X   X     X X     X X
X X XXXXXXX XXX XXXXX X XXX X XXXXX X XXX XXX X
X X   X X X   X   X X X X   X X X   X X       X
XXX XXX X XXX XXXXX X X X X X X X XXX X XXX XXX
X X   X X X X X   X   X X X X   X   X   X X   X
X X XXX X X X X X XXX XXXXX XXX X XXX X X XXX X
X   X         X X       X     X X   X X X     X
XXX X XXXXXXXXX X XXX XXXXX XXX XXX XXXXXXXXXXX
X X   X   X   X X   X   X     X X X X   X     X
X X XXXXX XXX XXX XXX X XXXXX XXX X X XXXXX XXX
X     X     X X X   X X   X             X   X X
X X X X XXXXX X X X XXXXX X XXXXXXX XXX XXX X X
X X X           X X X     X X   X     X       X
X XXXXX XXX XXXXXXX X XXX XXXXX XXXXX XXXXX XXX
X X   X   X X X     X   X X     X   X   X     X
XXX XXX XXXXX XXXXX XXX XXXXX XXX XXXXX XXX XXX
X       X     X     X   X         XE      X   X
X XXXXX X XXXXXXXXXXXXXXXXX XXX X XXX X XXXXXXX
X X X     X           X       X X     X X   X X
X X XXX X XXX XXX XXXXX X X XXX XXX X X X XXX X
X     X X       X   X   X X X   X   X X X     X
X XXX XXXXX XXX XXXXXXXXXXX X X XXXXXXX XXX XXX
X   X X X     X X     X     X X X     X     X X
XXXXX X X XXX XXX XXX XXX XXX XXXXX XXX X X X X
X   X X X   X X   X       X     X       X X X X
XXX XXX X X X XXX X XXXXXXXXX XXXXX XXX XXX X X
X         X X     X X             X   X   X   X
XXXXXXXXXXXXXXXXXXXXXXXXXXXXXXXXXXXXXXXXXXXXXXX