XXXXXXXXXXXXXXXXXXXXXXXXX
X       X X   X   X     X
X X X XXX XXX X XXXXX XXX
X X X X   X   X X       X
XXXXX XXX X XXX XXXXX XXX
X        S      X   X X X
XXXXX XXXXX XXXXXXX X X X
X         X X     X     X
X XXXXX XXXXX XXXXX XXX X
X     X   X X X X X X   X
X XXXXX XXX X X X XXXXX X
X   X     X     X       X
XXX X XXXXXXX XXX X XXXXX
X   X       X X X X     X
XXX XXX X XXX X X XXXXXXX
X   X   X   X     X     X
XXXXXXXXXXX X X XXX XXXXX
X         X   X     X X X
XXXXX X XXX X XXX XXX X X
X     X   X X X     X XEX
X XXX XXXXXXXXX X X X X X
X X             X X     X
X XXXXXXXXX XXXXX XXX X X
X   X       X     X   X X
XXXXXXXXXXXXXXXXXXXXXXXXX