XXXXXXXXXXXXXXXXXXXXXXXXX
X       X X X XEX     X X
X XXX X X X X X X XXXXX X
X X   X   X     X   X   X
X XXX XXX X XXX XXX XXX X
X X X X X X X     X     X
X X XXX X XXXXXXX XXX XXX
X     X XS    X         X
XXX XXX X XXXXXXX XXX X X
X X X   X   X X   X X X X
X X X XXXXX X X XXX X X X
X X X     X   X X     X X
X X XXX XXXXX XXXXXXX X X
X   X           X     X X
XXXXX X X XXXXXXXXX XXXXX
X X X X X     X     X   X
X X X XXX X X X X XXX XXX
X X X   X X X   X   X   X
X X X XXXXXXXXX XXX XXX X
X       X   X X X   X   X
XXX XXX X XXX XXXXX X X X
X X   X   X           X X
X X XXXXXXXXXXX X X X XXX
X           X   X X X   X
XXXXXXXXXXXXXXXXXXXXXXXXX