XXXXXXXXXXXXXXXXXXXXXXXXXXXXXXXXXXXXXXXXXXXXXXX
X X   X X X X X X   X         X           X   X
X XXX X X X X X XXX XXXXX X XXXXXXXXXXXXX X XXX
X       X   X   X   X X   X X   X       X     X
XXX X XXXXX XXX XXX X X XXX X X XXXXX XXX XXXXX
X X X         X   X X   X X   X X X   X   X   X
X X XXX XXXXX XXX X XXXXX X X XXX X XXX XXX XXX
X   X       X   X       X X X X X         X   X
XXXXX X XXXXX XXX XXXXXXX XXX X XXXXX XXX XXX X
X     X X       X     X             X X       X
XXXXXXX XXXXX X X XXX XXX X X XXXXXXX X X XXXXX
X     X    SX X   X X     X X   X     X X X   X
X X X XXXXXXX X X X XXX XXXXX XXX X X XXX X XXX
X X X     X   X X X     X         X X X       X
XXXXX XXXXXXXXXXXXX X XXXXX XXX XXX XXXXX X XXX
X X X X   X       X X X       X X X     X X X X
X X X XXX X XXXXX XXXXX XXXXXXXXX XXXXX XXXXX X
X   X         X   X     X   X X     X     X   X
XXX X XXXXXXXXX XXXXXXX XXX X X XXXXX X XXX X X
X X   X   X X   X   X X       X       X     X X
X XXX XXX X XXXXX XXX X XXX XXX XXX X XXXXX X X
X     X   X X   X     X X     X X   X   X X X X
X X X X X X X XXX XXXXXXXXX X X X X XXX X X XXX
X X X   X     X X       X   X X X X X     X   X
X XXX XXXXXXXXX XXX XXXXX XXX XXXXXXX X X XXXXX
X X         X     X     X   X X   X   X X X X X
X XXX XXXXX X X XXX XXXXX X XXXXX X XXXXXXX X X
X X   X       X       X   X     X X X         X
X XXXXXXXXXXX X X X X XXX X X XXX XXX X X X XXX
X X   X   X   X X X X     X X   X     X X X   X
X XXX X XXXXXXX X XXXXX XXXXX XXX XXXXXXX XXXXX
X         X X   X     X   X       X X X     X X
X X XXXXXXX X XXX X X XXXXX XXX X X X XXX XXX X
X X   X   X   X   X X   X   X X X   X X       X
XXX XXX XXXXXXXXX XXX XXX XXX X XXXXX XXXXXXX X
X           X     X   X X     X    EX         X
XXXXXXX X XXXXX X XXX X XXXXXXXXX XXXXX XXXXX X
X     X X     X X X       X X     X         X X
X X XXXXX XXXXXXXXX XXX XXX X XXX X XXXXXXX X X
X X       X           X X   X X   X   X X X X X
XXXXXXXXX X XXXXX XXXXXXX XXXXXXXXXXXXX X X XXX
X         X X       X X X           X     X X X
XXX XXXXXXX X X X X X X X X X XXXXX XXXXX X X X
X       X   X X X X       X X     X X         X
X XXX XXX X XXXXX XXXXXXXXX XXXXX X XXX XXX XXX
X X     X X X         X         X X   X X     X
XXXXXXXXXXXXXXXXXXXXXXXXXXXXXXXXXXXXXXXXXXXXXXX