XXXXXXXXXXXXXXXXXXXXXXXXX
X   X X   X   X         X
X X X X XXXXX XXX X X XXX
X X X X   X   X   X X   X
XXX X XXX XXX XXX XXXXXXX
X         X X X         X
X X X X X X X X XXXXX X X
X X X X X       X X   X X
X X X XXXXXXXXX X X XXX X
X X X X         X   X   X
XXXXX XXXXXXXXXXXXXXXXX X
X     X   X             X
X XXXXXXX X XXXXXXX X XXX
X     X X    E  X X X   X
XXXXX X XXX XXXXX X XXX X
X   X X   X   X   X   X X
X X X XXX X XXX XXX X XXX
X X X X   X X       X   X
X XXXXX XXXXX XXXXXXX XXX
X X       X X X   X X X X
X X XXXXX X X X XXX X X X
X X X   X     X X       X
X X X X XXX XXX XXX X X X
XS  X X       X     X X X
XXXXXXXXXXXXXXXXXXXXXXXXX