XXXXXXXXXXXXXXXXXXXXXXXXX
X           X X X   X   X
XXXXX X XXXXX X XXX XXX X
X     X X   X X       X X
X X XXX XXX X X XXXXX X X
X X X   X         X X X X
X XXX X X XXXXX XXX XXX X
X X X X     X         X X
XXX XXX X XXXXX X X XXX X
X   X   X X   X X X     X
XXX XXXXX X X X XXX X X X
X     X X XSX   X   X X X
XXXXX X X X XXX XXXXX XXX
X   X     X X X X X   X X
X X X X XXX X X X X XXX X
X X X X   X X     X     X
X X X XXX XXX XXXXX XXX X
XEX     X X X X   X   X X
X XXX XXXXX X X XXXXX X X
X   X   X       X X X X X
X XXXXX X XXXXXXX X X X X
X X     X   X X   X   X X
XXX XXXXX X X X XXX XXX X
X     X   X X         X X
XXXXXXXXXXXXXXXXXXXXXXXXX